"filename", "language", "Batch", "Markdown", "Gradle", "Java", "Java Properties", "comment", "blank", "total"
"/home/logan/Documents/GitHub/Game-Challenge/README.md", "Markdown", 0, 2, 0, 0, 0, 0, 1, 3
"/home/logan/Documents/GitHub/Game-Challenge/app/bin/main/org/game/App.class", "Java", 0, 0, 0, 19, 0, 0, 0, 19
"/home/logan/Documents/GitHub/Game-Challenge/app/bin/main/org/game/components/World.class", "Java", 0, 0, 0, 18, 0, 0, 0, 18
"/home/logan/Documents/GitHub/Game-Challenge/app/build.gradle", "Gradle", 0, 0, 30, 0, 0, 13, 13, 56
"/home/logan/Documents/GitHub/Game-Challenge/app/src/main/java/org/game/App.java", "Java", 0, 0, 0, 37, 0, 0, 18, 55
"/home/logan/Documents/GitHub/Game-Challenge/app/src/main/java/org/game/components/World.java", "Java", 0, 0, 0, 27, 0, 0, 14, 41
"/home/logan/Documents/GitHub/Game-Challenge/app/src/main/java/org/game/components/inventory/Inventory.java", "Java", 0, 0, 0, 0, 0, 0, 1, 1
"/home/logan/Documents/GitHub/Game-Challenge/app/src/main/java/org/game/components/inventory/Item.java", "Java", 0, 0, 0, 0, 0, 0, 1, 1
"/home/logan/Documents/GitHub/Game-Challenge/app/src/main/java/org/game/components/inventory/Slot.java", "Java", 0, 0, 0, 0, 0, 0, 1, 1
"/home/logan/Documents/GitHub/Game-Challenge/app/src/main/java/org/game/components/player/Player.java", "Java", 0, 0, 0, 35, 0, 0, 9, 44
"/home/logan/Documents/GitHub/Game-Challenge/app/src/main/java/org/game/components/tile/Tile.java", "Java", 0, 0, 0, 15, 0, 0, 6, 21
"/home/logan/Documents/GitHub/Game-Challenge/app/src/main/java/org/game/components/tile/TileLayer.java", "Java", 0, 0, 0, 15, 0, 0, 5, 20
"/home/logan/Documents/GitHub/Game-Challenge/app/src/main/java/org/game/components/tile/ToolType.java", "Java", 0, 0, 0, 6, 0, 0, 2, 8
"/home/logan/Documents/GitHub/Game-Challenge/gradle/wrapper/gradle-wrapper.properties", "Java Properties", 0, 0, 0, 0, 7, 0, 1, 8
"/home/logan/Documents/GitHub/Game-Challenge/gradlew.bat", "Batch", 41, 0, 0, 0, 0, 32, 22, 95
"/home/logan/Documents/GitHub/Game-Challenge/settings.gradle", "Gradle", 0, 0, 5, 0, 0, 7, 3, 15
"Total", "-", 41, 2, 35, 172, 7, 52, 97, 406